123 50
23 23 23 23 23 23 23 23 23 23 23 23 23 23 23 23 23 23 23 23 23 23 23 23 23 23 23 23 12 12 1 1 1 1 1 1 1 1 1 1 1 1 12 1 1 1 1 1 1 1 1 1 1 1 1 1 1 23 23 23 23 23 23 23 23 23 23 1 1 1 12 1 1 1 1 1 1 1 1 1 12 12 1 1 1 1 1 1 1 1 1 1 1 1 1 1 23 23 23 23 23 23 23 23 23 23 23 23 23 23 23 23 23 23 23 23 23 23 23 23 23 23 23
23 23 23 23 23 23 23 23 23 23 23 23 23 23 23 23 23 23 23 23 23 23 23 23 23 23 23 1 1 12 1 1 12 12 1 1 12 12 1 12 1 12 12 1 1 1 1 12 12 1 1 12 12 1 1 1 1 1 12 12 23 23 23 23 23 23 23 12 1 1 12 1 1 1 1 1 1 12 1 1 1 1 1 1 1 1 12 1 1 1 1 12 1 1 1 1 1 23 23 23 23 23 23 23 23 23 23 23 23 23 23 23 23 23 23 23 23 23 23 23 23 23 23
23 23 23 23 23 23 23 23 23 23 23 23 23 23 23 23 23 23 23 23 23 23 23 23 23 23 23 1 1 1 1 1 1 1 12 1 1 1 1 12 1 1 1 1 12 12 1 12 1 1 12 12 1 1 1 1 1 12 1 1 1 23 23 23 23 23 1 1 1 1 12 1 1 1 1 1 1 1 1 1 1 1 1 1 12 1 1 1 1 1 1 12 1 1 1 1 1 23 23 23 23 23 23 23 23 23 23 23 23 23 23 23 23 23 23 23 23 23 23 23 23 23 23
23 23 23 23 23 23 23 23 23 23 23 23 23 23 23 23 23 23 23 23 23 23 23 23 23 23 23 23 1 1 1 1 12 1 1 1 12 12 12 1 12 12 1 1 12 12 12 1 1 1 1 12 12 12 1 1 1 1 1 1 1 23 23 23 23 23 1 1 1 1 1 1 1 12 1 1 12 1 1 1 1 1 1 1 1 1 1 1 12 12 12 1 1 1 1 12 1 1 23 23 23 23 23 23 23 23 23 23 23 23 23 23 23 23 23 23 23 23 23 23 23 23 23
23 23 23 23 23 23 23 23 23 23 23 23 23 23 23 23 23 23 23 23 23 23 23 23 23 23 23 12 1 1 1 1 12 1 1 1 12 12 12 1 1 1 1 1 1 1 1 1 1 1 12 1 1 12 1 1 1 1 1 1 1 23 23 23 23 23 1 1 1 1 1 1 1 1 1 1 1 1 1 1 12 12 1 1 1 12 1 1 1 1 1 1 1 1 1 12 1 1 23 23 23 23 23 23 23 23 23 23 23 23 23 23 23 23 23 23 23 23 23 23 23 23 23
23 23 23 23 23 23 23 23 23 23 23 23 23 23 23 23 23 23 23 23 23 23 23 23 23 23 23 12 1 1 1 1 12 1 1 1 12 1 1 1 1 1 12 12 1 1 1 1 1 12 1 1 1 1 1 1 12 1 1 23 23 23 23 23 23 23 1 1 12 1 1 1 1 1 1 1 1 1 1 1 1 1 1 1 1 12 1 1 1 1 1 1 1 1 1 1 1 23 23 23 23 23 23 23 23 23 23 23 23 23 23 23 23 23 23 23 23 23 23 23 23 23 23
23 23 23 23 23 23 23 23 23 23 23 23 23 23 23 23 23 23 23 23 23 23 23 23 23 23 23 12 1 12 1 1 1 1 1 1 1 1 1 1 12 1 1 1 1 1 12 1 12 12 1 1 12 1 1 1 1 12 1 12 23 23 23 23 23 1 1 1 12 1 1 1 1 1 12 1 1 1 1 1 1 12 1 1 1 1 1 1 1 1 1 1 1 12 1 1 1 1 23 23 23 23 23 23 23 23 23 23 23 23 23 23 23 23 23 23 23 23 23 23 23 23 23
23 23 23 23 23 23 23 23 23 23 23 23 23 23 23 23 23 23 23 23 23 23 23 23 23 23 23 12 1 1 1 1 1 1 1 1 12 1 1 12 12 12 1 1 1 12 1 1 1 1 1 1 1 1 12 1 1 12 1 12 23 23 23 23 23 23 1 1 12 12 1 12 12 1 12 1 1 12 1 1 12 12 1 1 1 1 1 1 1 1 1 1 1 12 1 1 1 1 1 23 23 23 23 23 23 23 23 23 23 23 23 23 23 23 23 23 23 23 23 23 23 23 23
23 23 23 23 23 23 23 23 23 23 23 23 23 23 23 23 23 23 23 23 23 23 23 23 23 23 23 23 1 1 12 1 1 12 1 1 1 1 1 12 1 1 1 1 1 12 1 1 1 1 1 1 1 1 1 1 1 1 1 12 23 23 23 23 23 23 23 23 1 1 1 1 1 1 1 1 12 1 1 1 8 1 1 1 1 1 1 1 1 1 12 1 1 1 12 1 1 1 1 23 23 23 23 23 23 23 23 23 23 23 23 23 23 23 23 23 23 23 23 23 23 23 23
23 23 23 23 23 23 23 23 23 23 23 23 23 23 23 23 23 23 23 23 23 23 23 23 23 23 23 23 23 1 12 1 1 1 1 1 12 1 1 12 12 12 12 1 1 12 12 1 1 1 1 1 1 12 1 12 1 1 1 23 23 23 23 23 23 23 23 23 23 23 23 1 1 8 8 8 12 1 8 8 8 8 8 8 8 8 12 12 1 12 1 1 1 1 1 1 1 1 1 1 23 23 23 23 23 23 23 23 23 23 23 23 23 23 23 23 23 23 23 23 23 23 23
23 23 23 23 23 23 23 23 23 23 23 23 23 23 23 23 23 23 23 23 23 23 23 23 23 23 23 23 23 12 1 1 1 1 1 12 1 1 1 1 1 1 12 1 1 1 1 12 12 12 1 1 1 1 1 1 1 12 12 23 23 21 23 23 23 23 23 23 23 23 23 23 23 8 8 8 8 8 8 8 8 8 8 8 8 8 8 8 8 8 1 1 1 1 1 1 23 1 1 23 23 23 23 23 23 23 23 23 23 23 23 23 23 23 23 23 23 23 23 23 23 23 23
23 23 23 23 23 23 23 23 23 23 23 23 23 23 23 23 23 23 23 23 23 23 23 23 23 23 23 23 23 12 12 1 12 1 1 1 1 1 1 1 1 1 1 12 1 1 12 1 12 1 1 1 12 12 1 1 1 1 23 23 23 23 23 23 23 23 23 23 23 23 23 23 23 8 8 8 8 8 8 8 8 8 8 8 8 8 8 8 8 8 1 1 1 1 1 1 23 23 23 23 23 23 23 23 23 23 23 23 23 23 23 23 23 23 23 23 23 23 23 23 23 23 23
23 23 23 23 23 23 23 23 23 23 23 23 23 23 23 23 23 23 23 23 23 23 23 23 23 23 23 23 23 23 23 1 1 1 1 1 1 12 12 1 1 1 1 1 1 1 1 1 1 1 1 1 1 1 12 12 1 4 23 23 23 23 23 23 23 23 23 23 23 23 23 23 23 8 8 8 8 8 8 8 8 8 8 8 8 8 8 8 8 8 23 23 23 1 1 23 23 23 23 23 23 23 23 23 23 23 23 23 23 23 23 23 23 23 23 23 23 23 23 23 23 23 23
23 23 23 23 23 23 23 23 23 23 23 23 23 23 23 23 23 23 23 23 23 23 23 23 23 23 23 23 23 23 23 23 12 1 1 1 1 1 1 1 1 1 1 1 1 1 1 1 1 1 1 1 8 1 1 4 4 23 23 23 23 23 23 23 23 23 23 23 23 23 23 23 23 8 8 8 8 8 8 8 8 8 8 8 8 8 8 8 8 8 8 23 23 23 23 23 23 23 23 23 23 23 23 23 23 23 23 23 23 23 23 23 23 23 23 23 23 23 23 23 23 23 23
23 23 23 23 23 23 23 23 23 23 23 23 23 23 23 23 23 23 23 23 23 23 23 23 23 23 23 23 23 23 23 23 23 23 12 12 1 8 8 8 8 8 8 8 8 8 8 8 8 8 8 8 8 8 4 4 23 23 23 23 23 23 23 23 23 23 23 23 23 23 23 23 23 8 8 8 8 8 8 8 8 8 8 8 8 8 8 8 8 8 8 8 23 23 23 23 23 23 23 23 23 23 23 23 23 23 23 23 23 23 23 23 23 23 23 23 23 23 23 23 23 23 23
23 23 23 23 23 23 23 23 23 23 23 23 23 23 23 23 23 23 23 23 23 23 23 23 23 23 23 23 23 23 23 23 23 23 23 23 23 8 8 8 8 8 8 8 8 8 8 8 8 8 8 8 8 8 12 12 23 23 23 23 23 23 23 23 23 23 23 23 23 23 23 23 23 26 26 26 26 26 26 26 8 8 8 8 8 8 8 8 8 8 8 8 23 23 23 23 23 23 23 23 23 23 23 23 23 23 23 23 23 23 23 23 23 23 23 23 23 23 23 23 23 23 23
23 23 23 23 23 23 23 23 23 23 23 23 23 23 23 23 23 23 23 23 23 23 23 23 23 23 23 23 23 23 23 23 23 23 23 23 12 8 8 8 8 8 8 8 8 8 8 8 8 8 8 8 8 8 12 12 23 23 23 23 23 23 23 23 23 23 23 23 23 23 23 23 23 26 26 26 26 26 26 26 26 26 8 8 8 26 8 8 8 8 8 23 23 23 23 23 23 23 23 23 23 23 23 23 23 23 23 23 23 23 23 23 23 23 23 23 23 23 23 23 23 23 23
23 23 23 23 23 23 23 23 23 23 23 23 23 23 23 23 23 23 23 23 23 23 23 23 23 23 23 23 23 23 23 23 23 23 23 12 12 8 8 8 8 8 8 8 8 8 8 8 8 8 8 8 8 12 12 4 23 23 23 23 23 23 23 23 23 23 23 23 23 23 23 3 8 8 8 8 8 8 8 26 26 26 26 26 26 26 8 8 8 8 23 23 23 23 23 23 23 23 23 23 23 23 23 23 23 23 23 23 23 23 23 23 23 23 23 23 23 23 23 23 23 23 23
23 23 23 23 23 23 23 23 23 23 23 23 23 23 23 23 23 23 23 23 23 23 23 23 23 23 23 23 23 23 23 23 23 23 23 12 12 8 8 8 8 8 8 8 8 8 8 8 8 8 8 8 8 23 23 23 23 23 23 23 23 23 23 23 23 23 23 23 23 3 3 12 8 8 8 8 8 8 8 8 8 8 26 26 26 26 26 26 26 26 23 23 23 23 23 23 23 23 23 23 23 23 23 23 23 23 23 23 23 23 23 23 23 23 23 23 23 23 23 23 23 23 23
23 23 23 23 23 23 23 23 23 23 23 23 23 23 23 23 23 23 23 23 23 23 23 23 23 23 23 23 23 23 23 23 23 23 23 23 23 8 8 8 8 8 8 8 8 8 8 8 8 8 8 8 8 23 23 23 23 23 23 23 23 23 23 23 23 23 23 3 12 12 12 12 8 8 8 8 8 8 8 8 8 8 8 8 8 26 26 26 26 26 23 23 23 23 23 23 23 23 23 23 23 23 23 23 23 23 23 23 23 23 23 23 23 23 23 23 23 23 23 23 23 23 23
23 23 23 23 23 23 23 23 23 23 23 23 23 23 23 23 23 23 23 23 23 23 23 23 23 23 23 23 23 23 23 23 23 23 23 23 23 8 8 8 8 8 8 8 8 8 8 8 8 8 8 8 8 4 23 23 23 23 23 23 23 23 23 23 23 18 3 12 12 12 12 12 8 8 8 8 8 8 8 8 8 8 8 8 8 8 8 8 8 8 23 23 23 23 23 23 23 23 23 23 23 23 23 23 23 23 23 23 23 23 23 23 23 23 23 23 23 23 23 23 23 23 23
23 23 23 23 23 23 23 23 23 23 23 23 23 23 23 23 23 23 23 23 23 23 23 23 23 23 23 23 23 23 23 23 23 23 23 23 23 8 8 8 8 8 8 8 8 8 8 8 8 8 8 8 8 8 8 23 23 23 23 23 23 23 23 23 23 23 23 23 23 23 23 23 12 8 8 8 8 8 8 8 8 8 8 8 8 8 8 8 8 8 12 17 19 23 23 23 23 23 23 23 23 23 23 23 23 23 23 23 23 23 23 23 23 23 23 23 23 23 23 23 23 23 30
23 23 23 23 23 23 23 23 23 23 23 23 23 23 23 23 23 23 23 23 23 23 23 23 23 23 23 23 23 23 23 23 23 23 23 23 23 8 8 8 8 8 8 8 8 8 8 8 8 8 8 8 8 8 8 23 23 23 23 23 23 23 23 23 23 23 23 23 23 23 23 23 23 12 8 8 8 8 8 8 8 8 8 8 8 8 8 8 8 8 12 23 23 23 23 23 23 23 23 23 23 23 23 23 23 23 23 23 23 23 23 23 23 23 23 23 23 23 23 23 23 30 30
23 23 23 23 23 23 23 23 23 23 23 23 23 23 23 23 23 23 23 23 23 23 23 23 23 23 23 23 23 23 23 23 23 23 23 23 23 8 8 8 8 8 8 8 8 8 8 8 8 8 8 8 8 8 12 12 12 12 12 12 23 23 23 23 23 23 23 23 23 23 23 23 23 23 8 8 8 8 8 8 8 8 8 8 8 8 8 8 8 8 23 23 23 23 23 23 23 23 23 23 23 23 23 23 23 23 23 23 23 23 23 23 23 23 23 23 23 23 23 23 30 30 30
23 23 23 23 23 23 23 23 23 23 23 23 23 23 23 23 23 23 23 23 23 23 23 23 23 23 23 23 23 23 23 23 23 23 23 23 23 8 8 8 8 8 8 8 8 8 8 8 8 8 8 8 8 8 12 12 12 12 12 12 12 19 23 23 23 23 23 23 23 23 23 23 23 23 8 8 8 8 8 8 8 8 8 8 8 8 8 8 8 8 23 23 23 23 23 23 23 23 23 23 23 23 23 23 23 23 23 23 23 23 23 23 23 23 23 23 23 23 23 30 30 30 30
23 23 23 23 23 23 23 23 23 23 23 23 23 23 23 23 23 23 23 23 23 23 23 23 23 23 23 23 23 23 23 23 23 23 23 23 23 8 8 8 8 8 8 8 8 8 8 8 8 8 8 8 8 12 12 23 23 23 23 23 23 23 23 23 23 23 23 23 23 23 23 23 23 12 8 8 8 8 8 8 8 8 8 8 8 8 8 8 8 8 12 23 23 23 23 23 23 23 23 23 23 23 23 23 23 23 23 23 23 23 23 23 23 23 23 23 23 23 30 30 30 30 30
23 23 23 23 23 23 23 23 23 23 23 23 23 23 23 23 23 23 23 23 23 23 23 23 23 23 23 23 23 23 23 23 23 23 23 23 23 23 23 8 8 8 8 8 8 8 8 8 8 8 8 8 8 23 23 23 23 23 23 23 23 23 23 23 23 23 23 23 23 23 23 23 23 12 8 8 8 8 8 8 8 8 8 8 8 8 8 8 8 8 12 12 23 23 23 23 23 23 23 23 23 23 23 23 23 23 23 23 23 23 23 23 23 23 23 23 23 30 30 30 30 30 30
23 23 23 23 23 23 23 23 23 23 23 23 23 23 23 23 23 23 23 23 23 23 23 23 23 23 23 23 23 23 23 23 23 23 23 23 23 23 23 8 8 8 8 8 8 8 8 8 8 8 8 8 8 23 23 23 23 23 23 23 23 23 23 23 23 23 23 18 17 17 17 17 17 17 8 8 8 8 8 8 8 8 8 8 8 8 8 8 8 8 8 8 8 23 23 23 23 23 23 23 23 23 23 23 23 23 23 23 23 23 23 23 23 23 23 23 30 30 30 30 30 30 30
23 23 23 23 23 23 23 23 23 23 23 23 23 23 23 23 23 23 23 23 23 23 23 23 23 23 23 23 23 23 23 23 23 23 23 23 23 23 23 8 8 8 8 8 8 8 8 8 8 8 8 8 8 23 23 23 23 23 23 23 23 23 23 23 23 23 23 23 23 23 23 12 12 23 8 8 8 8 8 8 8 8 8 8 8 8 8 8 8 8 8 8 8 8 23 23 23 23 23 23 23 23 23 23 23 23 23 23 23 23 23 23 23 23 23 30 30 30 30 30 30 30 30
23 23 23 23 23 23 23 23 23 23 23 23 23 23 23 23 23 23 23 23 23 23 23 23 23 23 23 23 23 23 23 23 23 23 23 23 23 23 23 23 8 8 8 8 8 8 8 8 8 8 8 8 8 23 23 23 23 23 23 23 23 23 23 23 23 23 23 23 23 23 23 12 12 12 8 8 8 8 8 8 8 8 8 8 8 8 8 8 8 8 12 12 23 8 23 23 23 23 23 23 23 23 23 23 23 23 23 23 23 23 23 23 23 23 30 30 30 30 30 30 30 30 30
23 23 23 23 23 23 23 23 23 23 23 23 23 23 23 23 23 23 23 23 23 23 23 23 23 23 23 23 23 23 23 23 23 23 23 23 23 23 23 23 8 8 8 8 8 8 8 8 8 8 8 8 8 12 23 23 23 23 23 23 23 23 23 23 23 23 23 23 23 23 23 23 12 12 12 8 8 8 8 8 8 8 8 8 8 8 8 8 8 8 23 23 23 23 23 23 23 23 23 23 23 23 23 23 23 23 23 23 23 23 23 23 23 30 30 30 30 30 30 30 30 30 30
23 23 23 23 23 23 23 23 23 23 23 23 23 23 23 23 23 23 23 23 23 23 23 23 23 23 23 23 23 23 23 23 23 23 23 23 23 23 23 23 8 8 8 8 8 8 8 8 8 8 8 8 8 17 17 17 17 17 19 23 23 23 23 23 23 23 23 23 23 23 23 23 23 23 23 8 8 8 8 8 8 8 8 8 8 8 8 8 8 8 23 23 23 23 23 23 23 23 23 23 23 23 23 23 23 23 23 23 23 23 23 23 23 23 23 28 28 28 28 28 28 28 28
23 23 23 23 23 23 23 23 23 23 23 23 23 23 23 23 23 23 23 23 23 23 23 23 23 23 23 23 23 23 23 23 23 23 23 23 23 23 23 23 8 8 8 8 8 8 8 8 8 8 8 8 8 4 12 12 23 23 23 23 23 23 23 23 23 23 23 23 23 23 23 23 23 23 23 8 8 8 8 8 8 8 8 8 8 8 8 8 8 12 12 23 23 23 23 23 23 23 23 23 23 23 23 23 23 23 23 23 23 23 23 23 23 23 23 28 28 28 28 28 28 28 28
23 23 23 23 23 23 23 23 23 23 23 23 23 23 23 23 23 23 23 23 23 23 23 23 23 23 23 23 23 23 23 23 23 23 23 23 23 23 23 23 26 8 8 8 8 8 8 8 8 8 8 8 8 12 12 12 23 23 23 23 23 23 23 23 23 23 23 23 23 23 23 23 23 23 23 8 8 8 8 8 8 8 8 8 8 8 8 8 8 12 23 23 23 23 23 23 23 23 23 23 23 23 23 23 23 23 23 23 23 23 23 23 23 23 23 28 28 28 28 28 28 28 28
23 23 23 23 23 23 23 23 23 23 23 23 23 23 23 23 23 23 23 23 23 23 23 23 23 23 23 23 23 23 23 23 23 23 23 23 23 2 2 26 26 26 8 8 8 8 8 8 8 8 8 8 8 12 12 23 23 23 23 23 23 23 23 23 23 23 23 23 23 23 23 23 23 23 23 8 8 8 8 8 8 8 8 8 8 8 8 8 8 8 23 23 23 23 23 23 23 23 23 23 23 23 23 23 23 23 23 23 23 23 23 23 23 23 23 28 28 28 28 28 28 28 28
23 23 23 23 23 23 23 23 23 23 23 23 23 23 23 23 23 23 23 23 23 23 23 23 23 23 23 23 23 23 23 23 23 23 23 23 2 2 2 2 26 26 26 8 8 8 8 8 8 8 8 8 8 23 23 23 23 23 23 23 23 23 23 23 23 23 23 23 23 23 23 23 23 23 23 8 8 8 8 8 8 8 8 8 8 8 8 8 8 8 8 8 12 23 8 8 23 23 23 23 23 23 23 23 23 23 23 23 23 23 23 23 23 23 23 28 28 28 29 28 28 29 28
23 23 23 23 23 23 23 23 23 23 23 23 23 23 23 23 23 23 23 23 23 23 23 23 23 23 23 23 23 23 23 23 23 23 23 2 2 2 2 2 2 26 26 26 26 8 8 8 8 8 8 8 8 23 23 23 23 23 23 23 23 23 23 23 23 23 23 3 18 17 17 17 17 17 17 8 8 8 8 8 8 8 8 8 8 8 8 8 8 8 8 8 8 8 8 23 23 23 23 23 23 23 23 23 23 23 23 23 23 23 23 23 23 23 23 28 28 28 28 28 28 28 28
23 23 23 23 23 23 23 23 23 23 23 23 23 23 23 23 23 23 23 23 23 23 23 23 23 23 23 23 23 23 23 23 23 23 2 2 2 2 2 2 2 2 26 26 26 26 26 8 8 8 8 8 8 23 23 23 23 23 23 23 23 23 23 23 23 23 23 12 12 12 12 12 12 12 12 8 8 8 8 8 8 8 8 8 8 8 8 8 8 8 12 12 8 8 23 23 23 23 23 23 23 23 23 23 23 23 23 23 23 23 23 23 23 23 23 28 28 28 28 28 28 28 28
23 23 23 23 23 23 23 23 23 23 23 23 23 23 23 23 23 23 23 23 23 23 23 23 23 23 23 23 23 23 23 23 23 2 2 2 2 2 2 2 2 2 2 26 26 26 26 26 8 8 8 8 8 23 23 23 23 23 23 23 23 23 23 23 23 23 23 23 23 12 12 12 12 12 12 8 8 8 8 8 8 8 8 8 8 8 8 8 8 8 23 23 23 23 23 23 23 23 23 23 23 23 23 23 23 23 23 23 23 23 23 23 23 23 23 28 28 28 28 28 28 28 28
23 23 23 23 23 23 23 23 23 23 23 23 23 23 23 23 23 23 23 23 23 23 23 23 23 23 23 23 23 23 23 23 2 2 2 2 2 2 2 2 2 2 2 2 26 26 26 26 8 8 8 8 8 23 23 23 12 12 23 23 23 23 23 23 23 23 23 23 23 23 23 23 23 23 23 8 8 8 8 8 8 8 8 8 8 8 8 8 8 8 23 23 23 23 23 23 23 23 23 23 23 23 23 23 23 23 23 23 23 23 23 23 23 23 23 28 28 28 28 28 28 28 28
23 23 23 23 23 23 23 23 23 23 23 23 23 23 23 23 23 23 23 23 23 23 23 23 23 23 23 23 23 23 23 2 2 2 2 2 2 2 2 2 2 2 2 2 2 26 26 26 26 8 8 8 8 17 17 17 19 12 23 23 23 23 23 23 23 23 23 23 23 23 23 23 23 23 23 8 8 8 8 8 8 8 8 8 8 8 8 8 8 8 23 23 23 23 23 23 23 23 23 23 23 23 23 23 23 23 23 23 23 23 23 23 23 23 23 28 28 28 28 28 28 28 28
23 23 23 23 23 23 23 23 23 23 23 23 23 23 23 23 23 23 23 23 23 23 23 23 23 23 23 23 23 23 2 2 2 2 2 2 2 2 2 2 2 2 2 2 2 2 26 26 26 26 26 26 26 23 23 23 23 23 23 23 23 23 23 23 23 23 23 23 23 23 23 23 23 23 23 8 8 8 8 8 8 8 8 8 8 8 8 8 8 8 23 23 23 23 23 23 23 23 23 23 23 23 23 23 23 23 23 23 23 23 23 23 23 23 23 28 28 28 28 28 28 28 28
23 23 23 23 23 23 23 23 23 23 23 23 23 23 23 23 23 23 23 23 23 23 23 23 23 23 23 23 23 2 2 2 2 2 2 2 2 2 2 2 2 2 2 2 2 2 2 26 26 26 26 26 26 23 23 23 23 23 23 23 23 23 23 6 23 23 23 23 23 23 23 23 23 23 23 8 8 8 8 8 8 8 8 8 8 8 8 8 8 8 23 23 23 23 23 23 23 23 23 23 23 23 23 23 23 23 23 23 23 23 23 23 23 23 23 28 28 28 28 28 28 28 28
23 23 23 23 23 23 23 23 23 6 6 23 7 7 7 6 23 23 23 23 23 23 23 23 23 23 23 23 2 2 2 2 2 2 2 2 2 2 2 2 2 2 2 2 2 2 2 2 2 26 26 26 26 23 23 23 23 23 23 23 23 23 23 3 23 23 23 23 23 23 23 23 23 23 3 8 8 8 8 8 8 8 8 8 8 8 8 8 8 8 4 23 23 3 4 23 23 23 23 23 23 23 23 23 23 23 23 23 23 23 23 23 23 23 23 28 20 28 28 28 28 28 28
6 23 6 7 23 23 6 0 0 0 0 0 0 0 0 0 23 23 7 6 23 6 7 6 23 6 23 2 2 2 2 2 2 2 2 2 2 2 2 2 2 2 2 2 2 2 2 2 2 2 26 26 26 7 6 7 6 7 6 7 6 7 3 3 3 6 7 6 7 6 7 6 7 3 3 8 8 8 8 8 8 8 8 8 8 8 8 8 8 2 4 4 4 3 4 4 23 23 23 23 23 23 23 23 23 23 23 23 23 23 23 23 23 6 7 28 20 28 28 28 28 28 28
0 0 0 0 0 0 0 0 0 0 0 0 0 0 0 0 0 0 0 0 0 0 0 0 0 0 0 0 2 2 22 22 22 22 22 22 22 22 22 22 22 22 22 22 22 2 2 2 2 2 2 0 0 0 0 0 0 0 0 0 0 0 0 0 0 0 0 0 0 0 0 0 0 0 0 2 2 8 8 8 8 8 8 8 8 8 8 8 8 2 0 0 0 0 0 0 0 0 0 0 0 0 24 24 24 24 24 0 0 0 0 0 0 0 0 0 0 0 0 0 0 0 0
2 2 2 2 2 2 2 2 2 2 2 2 2 2 2 2 2 2 2 2 2 2 2 2 2 2 2 2 2 2 22 22 22 22 22 22 22 22 22 22 22 22 22 22 22 22 22 2 2 2 2 2 2 2 2 2 2 2 2 2 2 2 2 2 2 2 2 2 2 2 2 2 2 2 2 2 2 2 8 2 2 2 2 2 2 8 8 8 2 2 2 2 2 2 2 2 2 2 2 2 2 2 25 25 25 25 25 2 2 2 2 2 2 2 2 2 2 2 2 2 2 2 2
2 2 2 2 2 2 2 2 2 2 2 2 2 2 2 2 2 2 2 2 2 2 2 2 2 2 2 2 2 2 2 2 2 2 2 2 2 2 2 2 2 2 2 2 2 2 2 2 2 2 2 2 2 2 2 2 2 2 2 2 2 2 2 2 2 2 2 2 2 2 2 2 2 2 2 2 2 2 2 2 2 2 2 2 2 2 2 2 2 2 2 2 2 2 2 2 2 2 2 2 2 2 25 25 25 25 25 2 2 2 2 2 2 2 2 2 2 2 2 2 2 2 2
2 2 2 2 2 2 2 2 2 2 2 2 2 2 2 2 2 2 2 2 2 2 2 2 2 2 2 2 2 2 2 2 2 2 2 2 2 2 2 2 2 2 2 2 2 2 2 2 2 2 2 2 2 2 2 2 2 2 2 2 2 2 2 2 2 2 2 2 2 2 2 2 2 2 2 2 2 2 2 2 2 2 2 2 2 2 2 2 2 2 2 2 2 2 2 2 2 2 2 2 2 2 25 25 25 25 25 2 2 2 2 2 2 2 2 2 2 2 2 2 2 2 2
2 2 2 2 2 2 2 2 2 2 2 2 2 2 2 2 2 2 2 2 2 2 2 2 2 2 2 2 2 2 2 2 2 2 2 2 2 2 2 2 2 2 2 2 2 2 2 2 2 2 2 2 2 2 2 2 2 2 2 2 2 2 2 2 2 2 2 2 2 2 2 2 2 2 2 2 2 2 2 2 2 2 2 2 2 2 2 2 2 2 2 2 2 2 2 2 2 2 2 2 2 2 2 2 2 2 2 2 2 2 2 2 2 2 2 2 2 2 2 2 2 2 2